Room Capacity,Fifth Slot Usage,Double Acts,Single Gaps,Double Gaps,Triple Gaps,Total
332,5,750,336,234,0,1657
524,0,765,370,474,0,2133
488,0,809,356,327,0,1980
464,5,817,380,570,0,2236
502,10,768,372,468,0,2120
506,5,803,362,201,0,1877
427,0,804,310,276,0,1817
490,0,880,309,354,0,2033
412,0,973,348,447,0,2180
283,0,932,296,336,0,1847
