Room Capacity,Fifth Slot Usage,Double Acts,Single Gaps,Double Gaps,Triple Gaps,Total
0,10,267,89,3,0,369
0,15,255,87,15,0,372
0,5,312,99,12,0,428
10,0,324,52,0,0,386
9,5,285,100,18,0,417
0,5,267,102,18,0,392
16,0,282,85,15,0,398
0,10,250,116,24,0,400
11,5,284,80,15,0,395
9,5,332,78,9,0,433
