Room Capacity,Fifth Slot Usage,Double Acts,Single Gaps,Double Gaps,Triple Gaps,Total
381,5,871,425,210,0,1892
535,10,621,347,330,38000000,38001843
364,5,828,295,375,1000000,1001867
348,15,674,253,408,12000000,12001698
436,10,704,355,327,6000000,6001832
421,10,810,296,351,1000000,1001888
336,0,895,274,201,3000000,3001706
356,5,850,269,360,8000000,8001840
452,0,784,365,297,0,1898
356,5,912,345,276,1000000,1001894
