Room Capacity,Fifth Slot Usage,Double Acts,Single Gaps,Double Gaps,Triple Gaps,Total
484,0,800,307,366,0,1957
344,5,843,312,291,2000000,2001795
374,10,732,346,369,13000000,13001831
515,10,776,323,270,3000000,3001894
358,5,764,356,378,3000000,3001861
371,0,787,313,285,1000000,1001756
349,15,874,299,594,6000000,6002131
424,10,809,354,285,7000000,7001882
470,10,805,309,564,9000000,9002158
443,10,869,340,474,5000000,5002136
