Room Capacity,Fifth Slot Usage,Double Acts,Single Gaps,Double Gaps,Triple Gaps,Total
10,15,191,66,3,0,285
9,15,228,90,6,0,348
1,5,217,67,21,0,311
10,5,225,61,6,0,307
13,15,193,52,3,0,276
0,0,256,57,12,0,325
0,10,208,67,12,0,297
9,5,246,75,12,0,347
28,10,226,71,0,0,335
9,15,195,50,6,0,275
