Room Capacity,Fifth Slot Usage,Double Acts,Single Gaps,Double Gaps,Triple Gaps,Total
75,20,0,0,0,0,95
0,15,0,0,0,0,15
5,20,0,0,0,0,25
47,10,0,0,0,0,57
10,20,0,0,0,0,30
14,10,0,0,0,0,24
31,20,0,0,0,0,51
53,15,0,0,0,0,68
21,25,0,0,0,0,46
13,10,0,0,0,0,23
